........
.1111111
........
2222222.
........
.3333333
